{0,0,0,3}
{1,0,0,3}
{2,0,0,3}
{3,0,0,3}
{4,0,0,3}
{5,0,0,3}
{6,0,0,3}
{7,0,0,3}
{8,0,0,3}
{9,0,0,3}
{0,0,1,3}
{1,1,1,11}
{1,0,1,0}
{2,0,1,0}
{3,0,1,0}
{4,0,1,0}
{5,0,1,0}
{6,0,1,0}
{7,0,1,0}
{8,1,1,11}
{8,0,1,0}
{9,0,1,3}
{0,0,2,3}
{1,0,2,0}
{2,0,2,0}
{3,0,2,0}
{4,0,2,0}
{5,0,2,0}
{6,0,2,0}
{7,0,2,0}
{8,0,2,0}
{9,0,2,3}
{0,0,3,3}
{1,0,3,0}
{2,0,3,0}
{3,0,3,9}
{4,0,3,0}
{5,0,3,9}
{6,0,3,0}
{7,0,3,0}
{8,0,3,0}
{9,0,3,3}
{0,0,4,3}
{1,0,4,0}
{2,0,4,6}
{3,0,4,5}
{4,1,4,10}
{4,0,4,0}
{5,0,4,4}
{6,0,4,8}
{7,0,4,0}
{8,0,4,0}
{9,0,4,3}
{0,0,5,3}
{1,0,5,0}
{2,0,5,0}
{3,0,5,0}
{4,0,5,0}
{5,0,5,0}
{6,0,5,0}
{7,0,5,0}
{8,0,5,0}
{9,0,5,3}
{0,0,6,3}
{1,0,6,0}
{2,0,6,6}
{3,0,6,4}
{4,0,6,0}
{5,0,6,5}
{6,0,6,8}
{7,0,6,0}
{8,0,6,0}
{9,0,6,3}
{0,0,7,3}
{1,0,7,0}
{2,0,7,0}
{3,0,7,7}
{4,0,7,0}
{5,0,7,7}
{6,0,7,0}
{7,0,7,0}
{8,0,7,0}
{9,0,7,3}
{0,0,8,3}
{1,1,8,11}
{1,0,8,0}
{2,0,8,0}
{3,0,8,0}
{4,0,8,0}
{5,0,8,0}
{6,0,8,0}
{7,0,8,0}
{8,1,8,11}
{8,0,8,0}
{9,0,8,3}
{0,0,9,3}
{1,0,9,3}
{2,0,9,3}
{3,0,9,3}
{4,0,9,3}
{5,0,9,3}
{6,0,9,3}
{7,0,9,3}
{8,0,9,3}
{9,0,9,3}
{0,0,0,12}
{0,0,0,13}
{1,0,0,12}
{2,0,0,12}
{3,0,0,12}
{4,0,0,12}
{5,0,0,12}
{6,0,0,12}
{7,0,0,12}
{8,0,0,12}
{9,0,0,12}
{10,0,0,13}
{0,0,1,13}
{10,0,1,13}
{0,0,2,13}
{10,0,2,13}
{0,0,3,13}
{10,0,3,13}
{0,0,4,13}
{10,0,4,13}
{0,0,5,13}
{10,0,5,13}
{0,0,6,13}
{10,0,6,13}
{0,0,7,13}
{10,0,7,13}
{0,0,8,13}
{10,0,8,13}
{0,0,9,13}
{10,0,9,13}
{0,0,10,12}
{1,0,10,12}
{2,0,10,12}
{3,0,10,12}
{4,0,10,12}
{5,0,10,12}
{6,0,10,12}
{7,0,10,12}
{8,0,10,12}
{9,0,10,12}
